AVERINA	VALENTINA	VASIL'EVNA
AZhNAKINA	YuLIYa	ALEKSANDROVNA
AKSENOV	PAVEL	VALER'EVICh
ALEHINA	KSENIYa	VADIMOVNA
ALIOMAROV	ABAS	MARATOVICh
AL-KURD	NIDAL'	ZEJNOVICh
ANDREJChUK	OL'GA	OLEGOVNA
ANIKIN	MAKSIM	EVGEN'EVICh
ANTONOV	VLADISLAV	ALEKSEEVICh
APANASENKO	BOGDAN	SERGEEVICh
ARSAMAKOVA	ZARETA	RUSLANOVNA
ATMURZAEVA	ALINA	MARATOVNA
AFANASENKO	DAR'Ya	STEPANOVNA
AHVERDYaN	ELEN	ARTYuShAEVNA
AHUNZYaNOV	NAFIS	FANISOVICh
BAZYGIN	EGOR	IL'ICh
BAJKINA	ELIZAVETA	ALEKSEEVNA
BAJN-HARAEVA	BAINA	BADMAEVNA
BAKLAShKINA	KSENIYa	VADIMOVNA
BALAKINA	MARIYa	NIKOLAEVNA
BALHAEV	SULAMBEK	ALIHANOVICh
BARANOV	DANIIL	SERGEEVICh
BARDAKOV	KIRILL	VLADIMIROVICh
BEDEVKO	ILINA	ANDREEVNA
BERDNIKOV	PAVEL	KONSTANTINOVICh
BERDYGUZhIEV	NIKOLAJ	KUANShKALEEVICh
BERKUTOVA	MARIYa	IGOREVNA
BITUS	VIKTORIYa	ANDREEVNA
BOJKO	SERGEJ	ALEKSEEVICh
BOROZDIN	SERGEJ	NIKOLAEVICh
BOROUHIN	DMITRIJ	YuR'EVICh
BRIKSA	OKSANA	SERGEEVNA
BUGUNOV	ROMAN	DMITRIEVICh
BUDNIK	VALERIJ	NIKOLAEVICh
BULACEV	OLEG	RUSLANOVICh
BURDINA	VALERIYa	EFIMOVNA
BUTAKOVA	KATERINA	VLADIMIROVNA
BYDANCEV	GEORGIJ	ALEKSEEVICh
VARAKINA	UL'YaNA	VALER'EVNA
VARZINA	TAT'YaNA	SERGEEVNA
VASIL'EVA	ALINA	SERGEEVNA
VAS'KOVA	SOF'Ya	DMITRIEVNA
VIKULOV	VLADIMIR	EVGEN'EVICh
VOLKOV	DMITRIJ	ALEKSEEVICh
VOLKOVA	DAR'Ya	ANATOL'EVNA
VOLOGZhANINOV	DANILA	ALEKSEEVICh
VOLOZhANINA	IRINA	SERGEEVNA
VOROKOV	ASLAN	ZAUROVICh
GAVRILOVA	KSENIYa	ALEKSANDROVNA
GAVRYuTIN	GEORGIJ	DENISOVICh
GAJDAROVA	VALERIYa	VLADIMIROVNA
GALKIN	ARTUR	VLADIMIROVICh
GARSLYaN	TIGRAN	ARMENOVICh
GVOZDEVA	IRINA	VASIL'EVNA
GEVORKYaN	EDVIN	KARENOVICh
GLAVINA	EKATERINA	IGOREVNA
GLADKOVA	MARIYa	PETROVNA
GLUShchENKO	SOFIYa	SERGEEVNA
GOLOVANOVA	ALEKSANDRA	DMITRIEVNA
GOLOVKO	MARIYa	OLEGOVNA
GREChIHINA	NATAL'Ya	ALEKSANDROVNA
GREChIShKIN	KIRILL	YuR'EVICh
GRIGORYaN	EMMA	OVIKOVNA
GRINEVA	IYa	VADIMOVNA
GRIShAKOVA	KSENIYa	ANDREEVNA
GRIShchENKO	NATAL'Ya	ALEKSANDROVNA
GROMOVA	MARIYa	ALEKSEEVNA
GULIEV	HALIG	NAMIG OGLY
DEGTEVA	VARVARA	ANTONOVNA
DEMENT'EVA	YuLIYa	EVGEN'EVNA
DZhALALOVA	NUKIZhAT	GAJDARBEGOVNA
DZUCEVA	KARINA	ALANOVNA
DOLEVA	MILANA	ROMANOVNA
DUMNOVA	KRISTINA	VALER'EVNA
DUNAILOVA	ELEONORA	IOSIFOVNA
DYaDChENKO	KIRILL	VLADIMIROVICh
EGOROVA	POLINA	EGOROVNA
EMEL'YaNOV	IL'Ya	SERGEEVICh
EREMEEV	BOGDAN	IGOREVICh
EROShENKO	NIKITA	ANDREEVICh
ZAGITOVA	ALTYNAJ	AZATOVNA
ZADOROZhNIJ	IVAN	DENISOVICh
ZAJCEVA	YuLIYa	MIHAJLOVNA
ZENKIN	SERGEJ	DMITRIEVICh
ZONOVA	ANASTASIYa	SERGEEVNA
IVANOV	DANIL	SERGEEVICh
IVANOVA	MARIYa	VITAL'EVNA
IVANOVA	DAR'Ya	ANDREEVNA
IVANOVA	ROZA	VIKTOROVNA
IZGARYoV	SERGEJ	ALEKSEEVICh
IMAEVA	YaNA	RUSLANOVNA
ISAEVA	ALEKSANDRA	VITAL'EVNA
ISKAKOVA	AJShA	IMANGALIEVNA
KAGRAMANYaN	DIANA	GAGIKOVNA
KAZEEVA	ALEKSANDRA	ALEKSANDROVNA
KARPOVA	ANNA	ROMANOVNA
KAChMAZOVA	MILANA	EL'BRUSOVNA
KLINCOV	ALEKSANDR	ANDREEVICh
KOBRIN	IGOR'	VITAL'EVICh
KOVALEVA	DIANA	VADIMOVNA
KOGAN	NATAL'Ya	EVGEN'EVNA
KOLKOVA	OLESYa	ANDREEVNA
KOPYLOVA	ALEKSANDRA	VLADIMIROVNA
KORENEV	DMITRIJ	SERGEEVICh
KORChAGINA	KSENIYa	SERGEEVNA
KORYaChKIN	MAKSIM	ANATOL'EVICh
KOChUEVA	VALENTINA	VITAL'EVNA
KRIVOShchEKOVA	ANASTASIYa	ALEKSEEVNA
KROLIKOVA	ANNA	SERGEEVNA
KRYLOV	DANIL	ALEKSANDROVICh
KUDRYaVCEV	EVGENIJ	OLEGOVICh
KUDRYaVCEVA	DAR'Ya	DMITRIEVNA
KUZ'MENKO	PAVEL	SERGEEVICh
KUKANOV	ERENCEN	DENISOVICh
KULAGINA	ANNA	VLADISLAVOVNA
KULIKOVA	ELIZAVETA	EVGEN'EVNA
KUShNEREVICh	ANASTASIYa	LEONIDOVNA
LARIONOVA	MARINA	SERGEEVNA
LEVChENKO	VALERIJ	VALER'EVICh
LIFANOVA	POLINA	ANDREEVNA
MAVLYuTOV	EDUARD	MARATOVICh
MAGOMEDOV	VADIM	MIRZAFEROVICh
MAZANOVA	YuLIYa	PAVLOVNA
MAKARENKO	VLADISLAV	ALEKSANDROVICh
MARZAEV	ALEKSANDR	EVRIKOVICh
MARKINA	ALINA	OLEGOVNA
MARTYNOV	ANTON	SERGEEVICh
MEL'NIChENKO	SOFIYa	VLADIMIROVNA
MIZAMUDINOVA	AMINAT	EDVARDOVNA
MIZERKOVA	ANASTASIYa	SERGEEVNA
MILYaKOV	IL'Ya	VASIL'EVICh
MINIBAEV	DANIS	RENATOVICh
MINChENKOV	VLADISLAV	IGOREVICh
MOGUShKOV	MURAD	ZURABOVICh
MOLYaKOVA	DIANA	YuR'EVNA
MOROZOV	IL'Ya	KONSTANTINOVICh
MOChALOV	ANDREJ	SERGEEVICh
MUDRUK	ANASTASIYa	ALEKSANDROVNA
MURAV'EV	SERGEJ	ANDREEVICh
MUSAKOV	SERGEJ	VLADISLAVOVICh
NABIEVA	EL'MIRA	ADILOVNA
NEVMIENKO	EVGENIJ	ALEKSANDROVICh
NEFEDOV	IL'Ya	MIHAJLOVICh
NIKEEVA	UL'YaNA	DMITRIEVNA
NOVIKOV	ALEKSEJ	VIKTOROVICh
NOVIChKOVA	ELIZAVETA	ALEKSEEVNA
OBIShchENKO	NIKOLAJ	ALEKSEEVICh
OVSEP'YaN	AL'BERT	MINASOVICh
OVSYaNNIKOVA	SOFIYa	ALEKSANDROVNA
OS'KINA	KSENIYa	DENISOVNA
OTEPKO	SVETLANA	FEDOROVNA
OTRYVANOV	DMITRIJ	ALEKSANDROVICh
PAL'	VARVARA	EVGEN'EVNA
PENZIN	MATVEJ	IGOREVICh
PERFIL'EV	ARTUR	IGOREVICh
PETINA	ARINA	YuR'EVNA
PLETNEVA	VIKTORIYa	DMITRIEVNA
PODGUZOVA	VIKTORIYa	IVANOVNA
PODKOVYROVA	EKATERINA	ALEKSANDROVNA
POPOV	ARTEM	SERGEEVICh
POPOVA	TAT'YaNA	MIHAJLOVNA
POPOVChENKO	IGOR'	IGOREVICh
PORTNOJ	DMITRIJ	ALEKSANDROVICh
PROZhERINA	KAMILLA	VLADIMIROVNA
PChELKIN	ALEKSEJ	GENNAD'EVICh
PYZhOVA	POLINA	ALEKSANDROVNA
PYaTKOV	SERGEJ	IGOREVICh
RATANOVA	DAR'Ya	SERGEEVNA
ROZhKOVA	ANASTASIYa	PAVLOVNA
ROZOVA	MARGARITA	SERGEEVNA
ROMANENKO	DMITRIJ	VLADIMIROVICh
RUBANOVA	ALINA	VITAL'EVNA
SAMYGIN	DANIIL	NIKOLAEVICh
SVETLICKIJ	IGOR'	YuR'EVICh
SEMENOV	ALEKSANDR	SERGEEVICh
SEMENOVA	VERONIKA	VLADIMIROVNA
SEMYoNOVA	ANASTASIYa	MIHAJLOVNA
SYoMUShKIN	ROMAN	ALEKSANDROVICh
SEMChENKO	VALERIYa	OLEGOVNA
SERENKOVA	IRINA	VADIMOVNA
SKOROHOD	IVAN	ALEKSANDROVICh
SMIRNOV	SERGEJ	VLADISLAVOVICh
SOSNINA	STANISLAVA	IVANOVNA
STEPANOVA	ELIZAVETA	NIKOLAEVNA
STEPANOVA	ALINA	VITAL'EVNA
STRUKOV	YuRIJ	ALEKSANDROVICh
TRIFONOVA	DAR'Ya	SERGEEVNA
TRUBNIKOVA	ARINA	ALEKSANDROVNA
TURKINA	MARIYa	KONSTANTINOVNA
FEDINA	ANNA	NIKOLAEVNA
FESENKO	POLINA	TARASOVNA
FILIPPOV	NIKITA	ALEKSEEVICh
FIC	IRINA	OLEGOVNA
FOMINA	DAR'Ya	SERGEEVNA
HAMUKOV	ALIM	ASLANOVICh
HARTANOVICh	VALENTINA	ANDREEVNA
HVATKOV	ALEKSANDR	ANDREEVICh
HINCAGOVA	ILONA	TAJMURAZOVNA
HLEBODAROV	SERGEJ	ROMANOVICh
HRYKIN	NIKOLAJ	ALEKSANDROVICh
CAGARAEV	DAVID	MARATOVICh
CAMBUEVA	AJTA	ERDNIEVNA
CARIK	DENIS	EVGEN'EVICh
CYBIKZhAPOV	BULAT	OLEGOVICh
ChEMEZOV	MAKSIM	ALEKSANDROVICh
ChEPIK	DAR'Ya	GENNAD'EVNA
ChUHAREV	MATVEJ	DMITRIEVICh
ChUHROVA	ELIZAVETA	PAVLOVNA
ShABDINOVA	SABINA	SERVEROVNA
ShAKARYaN	MARA	ARAIKOVNA
ShAPKIN	EVGENIJ	GEORGIEVICh
ShAHMURZAEV	MAGOMED	IMRANOVICh
ShVYREV	MAKSIM	IGOREVICh
ShIRYaEV	ANTON	NIKOLAEVICh
ShOVHALOVA	POLINA	RUSLANOVNA
ShTEFAN	KIRILL	IGOREVICh
EL'DARHANOV	IL'YaS	MURADOVICh
YuRANOVA	KSENIYa	DENISOVNA
YaMShANOVA	ANASTASIYa	VALER'EVNA
YaNOVIChUTE	MILANA	SERGEEVNA
YaRNYH	VIKTORIYa	SERGEEVNA
