Найден пароль: AVERINA	VALENTINA	VASIL'EVNA

Найден пароль: AZhNAKINA	YuLIYa	ALEKSANDROVNA

Найден пароль: AKSENOV	PAVEL	VALER'EVICh

Найден пароль: ALEHINA	KSENIYa	VADIMOVNA

Найден пароль: ALIOMAROV	ABAS	MARATOVICh

Найден пароль: AL-KURD	NIDAL'	ZEJNOVICh

Найден пароль: ANDREJChUK	OL'GA	OLEGOVNA

Найден пароль: ANIKIN	MAKSIM	EVGEN'EVICh

Найден пароль: ANTONOV	VLADISLAV	ALEKSEEVICh

Найден пароль: APANASENKO	BOGDAN	SERGEEVICh

Найден пароль: ARSAMAKOVA	ZARETA	RUSLANOVNA

Найден пароль: ATMURZAEVA	ALINA	MARATOVNA

Найден пароль: AFANASENKO	DAR'Ya	STEPANOVNA

Найден пароль: AHVERDYaN	ELEN	ARTYuShAEVNA

Найден пароль: AHUNZYaNOV	NAFIS	FANISOVICh

Найден пароль: BAZYGIN	EGOR	IL'ICh

Найден пароль: BAJKINA	ELIZAVETA	ALEKSEEVNA

Найден пароль: BAJN-HARAEVA	BAINA	BADMAEVNA

Найден пароль: BAKLAShKINA	KSENIYa	VADIMOVNA

Найден пароль: BALAKINA	MARIYa	NIKOLAEVNA

Найден пароль: BALHAEV	SULAMBEK	ALIHANOVICh

Найден пароль: BARANOV	DANIIL	SERGEEVICh

Найден пароль: BARDAKOV	KIRILL	VLADIMIROVICh

Найден пароль: BEDEVKO	ILINA	ANDREEVNA

Найден пароль: BERDNIKOV	PAVEL	KONSTANTINOVICh

Найден пароль: BERDYGUZhIEV	NIKOLAJ	KUANShKALEEVICh

Найден пароль: BERKUTOVA	MARIYa	IGOREVNA

Найден пароль: BITUS	VIKTORIYa	ANDREEVNA

Найден пароль: BOJKO	SERGEJ	ALEKSEEVICh

Найден пароль: BOROZDIN	SERGEJ	NIKOLAEVICh

Найден пароль: BOROUHIN	DMITRIJ	YuR'EVICh

Найден пароль: BRIKSA	OKSANA	SERGEEVNA

Найден пароль: BUGUNOV	ROMAN	DMITRIEVICh

Найден пароль: BUDNIK	VALERIJ	NIKOLAEVICh

Найден пароль: BULACEV	OLEG	RUSLANOVICh

Найден пароль: BURDINA	VALERIYa	EFIMOVNA

Найден пароль: BUTAKOVA	KATERINA	VLADIMIROVNA

Найден пароль: BYDANCEV	GEORGIJ	ALEKSEEVICh

Найден пароль: VARAKINA	UL'YaNA	VALER'EVNA

Найден пароль: VARZINA	TAT'YaNA	SERGEEVNA

Найден пароль: VASIL'EVA	ALINA	SERGEEVNA

Найден пароль: VAS'KOVA	SOF'Ya	DMITRIEVNA

Найден пароль: VIKULOV	VLADIMIR	EVGEN'EVICh

Найден пароль: VOLKOV	DMITRIJ	ALEKSEEVICh

Найден пароль: VOLKOVA	DAR'Ya	ANATOL'EVNA

Найден пароль: VOLOGZhANINOV	DANILA	ALEKSEEVICh

Найден пароль: VOLOZhANINA	IRINA	SERGEEVNA

Найден пароль: VOROKOV	ASLAN	ZAUROVICh

Найден пароль: GAVRILOVA	KSENIYa	ALEKSANDROVNA

Найден пароль: GAVRYuTIN	GEORGIJ	DENISOVICh

Найден пароль: GAJDAROVA	VALERIYa	VLADIMIROVNA

Найден пароль: GALKIN	ARTUR	VLADIMIROVICh

Найден пароль: GARSLYaN	TIGRAN	ARMENOVICh

Найден пароль: GVOZDEVA	IRINA	VASIL'EVNA

Найден пароль: GEVORKYaN	EDVIN	KARENOVICh

Найден пароль: GLAVINA	EKATERINA	IGOREVNA

Найден пароль: GLADKOVA	MARIYa	PETROVNA

Найден пароль: GLUShchENKO	SOFIYa	SERGEEVNA

Найден пароль: GOLOVANOVA	ALEKSANDRA	DMITRIEVNA

Найден пароль: GOLOVKO	MARIYa	OLEGOVNA

Найден пароль: GREChIHINA	NATAL'Ya	ALEKSANDROVNA

Найден пароль: GREChIShKIN	KIRILL	YuR'EVICh

Найден пароль: GRIGORYaN	EMMA	OVIKOVNA

Найден пароль: GRINEVA	IYa	VADIMOVNA

Найден пароль: GRIShAKOVA	KSENIYa	ANDREEVNA

Найден пароль: GRIShchENKO	NATAL'Ya	ALEKSANDROVNA

Найден пароль: GROMOVA	MARIYa	ALEKSEEVNA

Найден пароль: GULIEV	HALIG	NAMIG OGLY

Найден пароль: DEGTEVA	VARVARA	ANTONOVNA

Найден пароль: DEMENT'EVA	YuLIYa	EVGEN'EVNA

Найден пароль: DZhALALOVA	NUKIZhAT	GAJDARBEGOVNA

Найден пароль: DZUCEVA	KARINA	ALANOVNA

Найден пароль: DOLEVA	MILANA	ROMANOVNA

Найден пароль: DUMNOVA	KRISTINA	VALER'EVNA

Найден пароль: DUNAILOVA	ELEONORA	IOSIFOVNA

Найден пароль: DYaDChENKO	KIRILL	VLADIMIROVICh

Найден пароль: EGOROVA	POLINA	EGOROVNA

Найден пароль: EMEL'YaNOV	IL'Ya	SERGEEVICh

Найден пароль: EREMEEV	BOGDAN	IGOREVICh

Найден пароль: EROShENKO	NIKITA	ANDREEVICh

Найден пароль: ZAGITOVA	ALTYNAJ	AZATOVNA

Найден пароль: ZADOROZhNIJ	IVAN	DENISOVICh

Найден пароль: ZAJCEVA	YuLIYa	MIHAJLOVNA

Найден пароль: ZENKIN	SERGEJ	DMITRIEVICh

Найден пароль: ZONOVA	ANASTASIYa	SERGEEVNA

Найден пароль: IVANOV	DANIL	SERGEEVICh

Найден пароль: IVANOVA	MARIYa	VITAL'EVNA

Найден пароль: IVANOVA	DAR'Ya	ANDREEVNA

Найден пароль: IVANOVA	ROZA	VIKTOROVNA

Найден пароль: IZGARYoV	SERGEJ	ALEKSEEVICh

Найден пароль: IMAEVA	YaNA	RUSLANOVNA

Найден пароль: ISAEVA	ALEKSANDRA	VITAL'EVNA

Найден пароль: ISKAKOVA	AJShA	IMANGALIEVNA

Найден пароль: KAGRAMANYaN	DIANA	GAGIKOVNA

Найден пароль: KAZEEVA	ALEKSANDRA	ALEKSANDROVNA

Найден пароль: KARPOVA	ANNA	ROMANOVNA

Найден пароль: KAChMAZOVA	MILANA	EL'BRUSOVNA

Найден пароль: KLINCOV	ALEKSANDR	ANDREEVICh

Найден пароль: KOBRIN	IGOR'	VITAL'EVICh

Найден пароль: KOVALEVA	DIANA	VADIMOVNA

Найден пароль: KOGAN	NATAL'Ya	EVGEN'EVNA

Найден пароль: KOLKOVA	OLESYa	ANDREEVNA

Найден пароль: KOPYLOVA	ALEKSANDRA	VLADIMIROVNA

Найден пароль: KORENEV	DMITRIJ	SERGEEVICh

Найден пароль: KORChAGINA	KSENIYa	SERGEEVNA

Найден пароль: KORYaChKIN	MAKSIM	ANATOL'EVICh

Найден пароль: KOChUEVA	VALENTINA	VITAL'EVNA

Найден пароль: KRIVOShchEKOVA	ANASTASIYa	ALEKSEEVNA

Найден пароль: KROLIKOVA	ANNA	SERGEEVNA

Найден пароль: KRYLOV	DANIL	ALEKSANDROVICh

Найден пароль: KUDRYaVCEV	EVGENIJ	OLEGOVICh

Найден пароль: KUDRYaVCEVA	DAR'Ya	DMITRIEVNA

Найден пароль: KUZ'MENKO	PAVEL	SERGEEVICh

Найден пароль: KUKANOV	ERENCEN	DENISOVICh

Найден пароль: KULAGINA	ANNA	VLADISLAVOVNA

Найден пароль: KULIKOVA	ELIZAVETA	EVGEN'EVNA

Найден пароль: KUShNEREVICh	ANASTASIYa	LEONIDOVNA

Найден пароль: LARIONOVA	MARINA	SERGEEVNA

Найден пароль: LEVChENKO	VALERIJ	VALER'EVICh

Найден пароль: LIFANOVA	POLINA	ANDREEVNA

Найден пароль: MAVLYuTOV	EDUARD	MARATOVICh

Найден пароль: MAGOMEDOV	VADIM	MIRZAFEROVICh

Найден пароль: MAZANOVA	YuLIYa	PAVLOVNA

Найден пароль: MAKARENKO	VLADISLAV	ALEKSANDROVICh

Найден пароль: MARZAEV	ALEKSANDR	EVRIKOVICh

Найден пароль: MARKINA	ALINA	OLEGOVNA

Найден пароль: MARTYNOV	ANTON	SERGEEVICh

Найден пароль: MEL'NIChENKO	SOFIYa	VLADIMIROVNA

Найден пароль: MIZAMUDINOVA	AMINAT	EDVARDOVNA

Найден пароль: MIZERKOVA	ANASTASIYa	SERGEEVNA

Найден пароль: MILYaKOV	IL'Ya	VASIL'EVICh

Найден пароль: MINIBAEV	DANIS	RENATOVICh

Найден пароль: MINChENKOV	VLADISLAV	IGOREVICh

Найден пароль: MOGUShKOV	MURAD	ZURABOVICh

Найден пароль: MOLYaKOVA	DIANA	YuR'EVNA

Найден пароль: MOROZOV	IL'Ya	KONSTANTINOVICh

Найден пароль: MOChALOV	ANDREJ	SERGEEVICh

Найден пароль: MUDRUK	ANASTASIYa	ALEKSANDROVNA

Найден пароль: MURAV'EV	SERGEJ	ANDREEVICh

Найден пароль: MUSAKOV	SERGEJ	VLADISLAVOVICh

Найден пароль: NABIEVA	EL'MIRA	ADILOVNA

Найден пароль: NEVMIENKO	EVGENIJ	ALEKSANDROVICh

Найден пароль: NEFEDOV	IL'Ya	MIHAJLOVICh

Найден пароль: NIKEEVA	UL'YaNA	DMITRIEVNA

Найден пароль: NOVIKOV	ALEKSEJ	VIKTOROVICh

Найден пароль: NOVIChKOVA	ELIZAVETA	ALEKSEEVNA

Найден пароль: OBIShchENKO	NIKOLAJ	ALEKSEEVICh

Найден пароль: OVSEP'YaN	AL'BERT	MINASOVICh

Найден пароль: OVSYaNNIKOVA	SOFIYa	ALEKSANDROVNA

Найден пароль: OS'KINA	KSENIYa	DENISOVNA

Найден пароль: OTEPKO	SVETLANA	FEDOROVNA

Найден пароль: OTRYVANOV	DMITRIJ	ALEKSANDROVICh

Найден пароль: PAL'	VARVARA	EVGEN'EVNA

Найден пароль: PENZIN	MATVEJ	IGOREVICh

Найден пароль: PERFIL'EV	ARTUR	IGOREVICh

Найден пароль: PETINA	ARINA	YuR'EVNA

Найден пароль: PLETNEVA	VIKTORIYa	DMITRIEVNA

Найден пароль: PODGUZOVA	VIKTORIYa	IVANOVNA

Найден пароль: PODKOVYROVA	EKATERINA	ALEKSANDROVNA

Найден пароль: POPOV	ARTEM	SERGEEVICh

Найден пароль: POPOVA	TAT'YaNA	MIHAJLOVNA

Найден пароль: POPOVChENKO	IGOR'	IGOREVICh

Найден пароль: PORTNOJ	DMITRIJ	ALEKSANDROVICh

Найден пароль: PROZhERINA	KAMILLA	VLADIMIROVNA

Найден пароль: PChELKIN	ALEKSEJ	GENNAD'EVICh

Найден пароль: PYZhOVA	POLINA	ALEKSANDROVNA

Найден пароль: PYaTKOV	SERGEJ	IGOREVICh

Найден пароль: RATANOVA	DAR'Ya	SERGEEVNA

Найден пароль: ROZhKOVA	ANASTASIYa	PAVLOVNA

Найден пароль: ROZOVA	MARGARITA	SERGEEVNA

Найден пароль: ROMANENKO	DMITRIJ	VLADIMIROVICh

Найден пароль: RUBANOVA	ALINA	VITAL'EVNA

Найден пароль: SAMYGIN	DANIIL	NIKOLAEVICh

Найден пароль: SVETLICKIJ	IGOR'	YuR'EVICh

Найден пароль: SEMENOV	ALEKSANDR	SERGEEVICh

Найден пароль: SEMENOVA	VERONIKA	VLADIMIROVNA

Найден пароль: SEMYoNOVA	ANASTASIYa	MIHAJLOVNA

Найден пароль: SYoMUShKIN	ROMAN	ALEKSANDROVICh

Найден пароль: SEMChENKO	VALERIYa	OLEGOVNA

Найден пароль: SERENKOVA	IRINA	VADIMOVNA

Найден пароль: SKOROHOD	IVAN	ALEKSANDROVICh

Найден пароль: SMIRNOV	SERGEJ	VLADISLAVOVICh

Найден пароль: SOSNINA	STANISLAVA	IVANOVNA

Найден пароль: STEPANOVA	ELIZAVETA	NIKOLAEVNA

Найден пароль: STEPANOVA	ALINA	VITAL'EVNA

Найден пароль: STRUKOV	YuRIJ	ALEKSANDROVICh

Найден пароль: TRIFONOVA	DAR'Ya	SERGEEVNA

Найден пароль: TRUBNIKOVA	ARINA	ALEKSANDROVNA

Найден пароль: TURKINA	MARIYa	KONSTANTINOVNA

Найден пароль: FEDINA	ANNA	NIKOLAEVNA

Найден пароль: FESENKO	POLINA	TARASOVNA

Найден пароль: FILIPPOV	NIKITA	ALEKSEEVICh

Найден пароль: FIC	IRINA	OLEGOVNA

Найден пароль: FOMINA	DAR'Ya	SERGEEVNA

Найден пароль: HAMUKOV	ALIM	ASLANOVICh

Найден пароль: HARTANOVICh	VALENTINA	ANDREEVNA

Найден пароль: HVATKOV	ALEKSANDR	ANDREEVICh

Найден пароль: HINCAGOVA	ILONA	TAJMURAZOVNA

Найден пароль: HLEBODAROV	SERGEJ	ROMANOVICh

Найден пароль: HRYKIN	NIKOLAJ	ALEKSANDROVICh

Найден пароль: CAGARAEV	DAVID	MARATOVICh

Найден пароль: CAMBUEVA	AJTA	ERDNIEVNA

Найден пароль: CARIK	DENIS	EVGEN'EVICh

Найден пароль: CYBIKZhAPOV	BULAT	OLEGOVICh

Найден пароль: ChEMEZOV	MAKSIM	ALEKSANDROVICh

Найден пароль: ChEPIK	DAR'Ya	GENNAD'EVNA

Найден пароль: ChUHAREV	MATVEJ	DMITRIEVICh

Найден пароль: ChUHROVA	ELIZAVETA	PAVLOVNA

Найден пароль: ShABDINOVA	SABINA	SERVEROVNA

Найден пароль: ShAKARYaN	MARA	ARAIKOVNA

Найден пароль: ShAPKIN	EVGENIJ	GEORGIEVICh

Найден пароль: ShAHMURZAEV	MAGOMED	IMRANOVICh

Найден пароль: ShVYREV	MAKSIM	IGOREVICh

Найден пароль: ShIRYaEV	ANTON	NIKOLAEVICh

Найден пароль: ShOVHALOVA	POLINA	RUSLANOVNA

Найден пароль: ShTEFAN	KIRILL	IGOREVICh

Найден пароль: EL'DARHANOV	IL'YaS	MURADOVICh

Найден пароль: YuRANOVA	KSENIYa	DENISOVNA

Найден пароль: YaMShANOVA	ANASTASIYa	VALER'EVNA

Найден пароль: YaNOVIChUTE	MILANA	SERGEEVNA

Найден пароль: YaRNYH	VIKTORIYa	SERGEEVNA

